11111111111111111111
1E00000000000C000001
10000010010000000001
100000100100000C0001
1000001C010000000001
10000011110000000001
1000000000000C000001
10C000000000000000P1
11111111111111111111
