11111
10C01
10E01
10C01
10P01
11111